15 x 20
*******O************
*  R        R      *
*     *  *  *      *
**          *      *
*   **     *   *   O
*   *      *  *    *
*   H  * *   R  *  *
*  *           **  *
*     R      *     *
*                  * 
*       r          * 
*         *     R  *
*  R               *
*          R       *
*************O******
