10 x 19
*******************
*           r     *
*                 *
*        H        *
*  r              *
*                 *
*            r    *
*  r              *
*     r          r*
**********O********
