10 x 20
********************
*  R        R      *
*     *  *  *      *
*       rH  *      *
*   **     *   *   *
*   *      *  *    *
*     * *    R  *  *
*  *           **  *
*     R      *     *
********************
