15 x 20
********************
*  R        R      *
*     *  *  *      *
**          *      *
*   **     *   *   *
*   *      *  *    *
*   H  * *   R  *  *
*  *           **  *
*     R      *     *
*                  * 
*       r          * 
*         *     R  *
*  R               *
*          R       *
********************
