10 x 20
********O***********
*  R        R      *
*   R *  *  *      *
O        H  *      *
*   **     *   *   *
*   *      *  *    *
*     * *    R  *  *
*  *           **  *
*     R      *     *
********************