10 x 19
*******************
*  *        R     *
*   * *  *  *     *
*        H  *     *
*  R *     *   *  *
*   *      *  *   *
*     * *    R  * *
*  R           ** *
*     R      *   r*
*******************